GMU,Antlerless Harvest,Antlered Harvest,Total Harvest,1 Point,2 Point,3 Point,4 Point,5 Point,6+ Point
"101
                - SHERMAN",1,1,2,0,0,0,0,0,1
"105
                - KELLY HILL",1,0,1,0,0,0,0,0,0
"108
                - DOUGLAS",2,0,2,0,0,0,0,0,0
"111
                - ALADDIN",2,0,2,0,0,0,0,0,0
"113
                - SELKIRK",6,0,6,0,0,0,0,0,0
"117
                - 49 DEGREES NORTH",13,0,13,0,0,0,0,0,0
"121
                - HUCKLEBERRY",4,0,4,0,0,0,0,0,0
Totals,29,1,30,0,0,0,0,0,1
"124
                - MOUNT SPOKANE",2,0,2,0,0,0,0,0,0
"127
                - MICA PEAK",0,0,0,0,0,0,0,0,0
"130
                - CHENEY",6,1,7,0,0,0,0,1,0
"133
                - ROOSEVELT",1,0,1,0,0,0,0,0,0
"136
                - HARRINGTON",0,0,0,0,0,0,0,0,0
"139
                - STEPTOE",0,0,0,0,0,0,0,0,0
"142
                - ALMOTA",0,0,0,0,0,0,0,0,0
Totals,9,1,10,0,0,0,0,1,0
"145
                - MAYVIEW",0,0,0,0,0,0,0,0,0
"149
                - PRESCOTT",2,1,3,0,0,0,0,0,1
"154
                - BLUE CREEK",2,6,8,0,0,0,0,0,6
"157
                - MILL CREEK WATERSHED",0,5,5,0,0,0,0,1,4
"162
                - DAYTON",0,3,3,0,0,0,0,0,3
"163
                - MARENGO",0,0,0,0,0,0,0,0,0
"166
                - TUCANNON",0,2,2,0,0,0,0,0,2
"169
                - WENAHA",0,6,6,0,0,0,0,0,6
"172
                - MOUNTAIN VIEW",3,10,13,0,0,0,0,1,9
"175
                - LICK CREEK",0,2,2,0,0,0,0,0,2
"178
                - PEOLA",1,3,4,0,0,0,0,0,3
"181
                - COUSE",7,4,11,0,0,0,0,0,4
"186
                - GRANDE RONDE",0,0,0,0,0,0,0,0,0
Totals,15,42,57,0,0,0,0,2,40
"372
                - RATTLESNAKE HILLS",4,4,8,0,0,0,0,1,3
"373
                - HORSE HEAVEN",2,0,2,0,0,0,0,0,0
"379
                - RINGOLD",0,0,0,0,0,0,0,0,0
"381
                - KAHLOTUS",0,0,0,0,0,0,0,0,0
Totals,6,4,10,0,0,0,0,1,3
"272
                - BEEZLEY",0,0,0,0,0,0,0,0,0
"278
                - WAHLUKE",0,0,0,0,0,0,0,0,0
"284
                - RITZVILLE",0,0,0,0,0,0,0,0,0
"290
                - DESERT",0,0,0,0,0,0,0,0,0
Totals,0,0,0,0,0,0,0,0,0
"203
                - PASAYTEN",0,0,0,0,0,0,0,0,0
"204
                - OKANOGAN EAST",0,0,0,0,0,0,0,0,0
"209
                - WANNACUT",0,0,0,0,0,0,0,0,0
"215
                - SINLAHEKIN",0,0,0,0,0,0,0,0,0
"218
                - CHEWUCH",0,0,0,0,0,0,0,0,0
"224
                - PEARRYGIN",0,0,0,0,0,0,0,0,0
"231
                - GARDNER",0,0,0,0,0,0,0,0,0
"233
                - POGUE",0,0,0,0,0,0,0,0,0
"239
                - CHILIWIST",0,0,0,0,0,0,0,0,0
"242
                - ALTA",0,0,0,0,0,0,0,0,0
Totals,0,0,0,0,0,0,0,0,0
"243
                - MANSON",0,0,0,0,0,0,0,0,0
"244
                - CLARK",0,0,0,0,0,0,0,0,0
"245
                - CHIWAWA",0,0,0,0,0,0,0,0,0
"246
                - SLIDE RIDGE",0,0,0,0,0,0,0,0,0
"247
                - ENTIAT",0,0,0,0,0,0,0,0,0
"248
                - BIG BEND",0,0,0,0,0,0,0,0,0
"249
                - ALPINE",1,0,1,0,0,0,0,0,0
"250
                - SWAKANE",1,0,1,0,0,0,0,0,0
"251
                - MISSION",46,5,51,0,0,0,0,0,5
"254
                - SAINT ANDREWS",0,0,0,0,0,0,0,0,0
"260
                - FOSTER CREEK",0,0,0,0,0,0,0,0,0
"262
                - WITHROW",0,0,0,0,0,0,0,0,0
"266
                - BADGER",1,0,1,0,0,0,0,0,0
"269
                - MOSES COULEE",0,0,0,0,0,0,0,0,0
Totals,49,5,54,0,0,0,0,0,5
"328
                - NANEUM",35,10,45,0,0,0,1,2,7
"329
                - QUILOMENE",24,0,24,0,0,0,0,0,0
"330
                - WEST BAR",4,0,4,0,0,0,0,0,0
"334
                - ELLENSBURG",0,4,4,0,0,0,1,1,2
"335
                - TEANAWAY",8,6,14,0,0,0,0,1,5
"336
                - TANEUM",29,3,32,0,0,0,0,1,2
"340
                - MANASTASH",46,6,52,0,0,0,0,1,5
"342
                - UMTANUM",57,4,61,0,0,0,1,1,2
"346
                - LITTLE NACHES",46,13,59,0,0,1,0,5,7
"352
                - NILE",12,2,14,0,0,0,0,0,2
"356
                - BUMPING",11,4,15,0,0,0,2,0,2
"360
                - BETHEL",13,5,18,0,0,0,0,1,4
"364
                - RIMROCK",46,17,63,1,3,1,0,5,7
"368
                - COWICHE",71,6,77,1,0,0,0,0,5
"371
                - ALKALI",42,18,60,2,0,0,0,1,15
Totals,444,98,542,4,3,2,5,19,65
"382
                - EAST KLICKITAT",0,0,0,0,0,0,0,0,0
"388
                - GRAYBACK",0,0,0,0,0,0,0,0,0
"554
                - YALE",1,1,2,0,0,0,0,1,0
"560
                - LEWIS RIVER",9,0,9,0,0,0,0,0,0
"564
                - BATTLE GROUND",0,0,0,0,0,0,0,0,0
"568
                - WASHOUGAL",4,0,4,0,0,0,0,0,0
"572
                - SIOUXON",3,0,3,0,0,0,0,0,0
"574
                - WIND RIVER",2,0,2,0,0,0,0,0,0
"578
                - WEST KLICKITAT",11,0,11,0,0,0,0,0,0
Totals,30,1,31,0,0,0,0,1,0
"501
                - LINCOLN",0,0,0,0,0,0,0,0,0
"503
                - RANDLE",1,0,1,0,0,0,0,0,0
"504
                - STELLA",0,0,0,0,0,0,0,0,0
"505
                - MOSSYROCK",1,0,1,0,0,0,0,0,0
"506
                - WILLAPA HILLS",24,2,26,0,0,0,0,2,0
"510
                - STORMKING",0,0,0,0,0,0,0,0,0
"513
                - SOUTH RAINIER",0,1,1,0,0,0,0,0,1
"516
                - PACKWOOD",0,0,0,0,0,0,0,0,0
"520
                - WINSTON",3,0,3,0,0,0,0,0,0
"522
                - LOO-WIT",11,21,32,1,0,0,4,11,5
"524
                - MARGARET",3,8,11,0,0,0,2,3,3
"530
                - RYDERWOOD",11,0,11,0,0,0,0,0,0
"550
                - COWEEMAN",6,1,7,0,1,0,0,0,0
"556
                - TOUTLE",9,22,31,4,1,2,6,9,0
Totals,69,55,124,5,2,2,12,25,9
"652
                - PUYALLUP",6,0,6,0,0,0,0,0,0
"653
                - WHITE RIVER",3,29,32,3,0,0,2,8,16
"654
                - MASHEL",6,0,6,0,0,0,0,0,0
"655
                - ANDERSON ISLAND",0,0,0,0,0,0,0,0,0
"666
                - DESCHUTES",0,0,0,0,0,0,0,0,0
"667
                - SKOOKUMCHUCK",7,1,8,0,0,0,0,0,1
Totals,22,30,52,3,0,0,2,8,17
"422
                - VASHON - MAURY",0,0,0,0,0,0,0,0,0
"454
                - ISSAQUAH",0,0,0,0,0,0,0,0,0
"460
                - SNOQUALMIE",0,0,0,0,0,0,0,0,0
"466
                - STAMPEDE",0,0,0,0,0,0,0,0,0
"485
                - GREEN RIVER",3,3,6,0,0,0,0,2,1
"490
                - CEDAR RIVER",0,0,0,0,0,0,0,0,0
Totals,3,3,6,0,0,0,0,2,1
"410
                - ISLANDS",0,0,0,0,0,0,0,0,0
"411
                - ORCAS",0,0,0,0,0,0,0,0,0
"412
                - SHAW",0,0,0,0,0,0,0,0,0
"413
                - SAN JUAN",0,0,0,0,0,0,0,0,0
"414
                - LOPEZ",0,0,0,0,0,0,0,0,0
"415
                - BLAKELY",0,0,0,0,0,0,0,0,0
"416
                - DECATUR",0,0,0,0,0,0,0,0,0
"417
                - CYPRESS",0,0,0,0,0,0,0,0,0
"419
                - GUEMES",0,0,0,0,0,0,0,0,0
"420
                - WHIDBEY",0,0,0,0,0,0,0,0,0
"421
                - CAMANO",0,0,0,0,0,0,0,0,0
"448
                - STILLAGUAMISH",0,0,0,0,0,0,0,0,0
"450
                - CASCADE",0,0,0,0,0,0,0,0,0
Totals,0,0,0,0,0,0,0,0,0
"407
                - NORTH SOUND",0,0,0,0,0,0,0,0,0
"418
                - NOOKSACK",2,16,18,0,0,2,1,8,5
"426
                - DIABLO",0,0,0,0,0,0,0,0,0
"437
                - SAUK",11,10,21,1,0,1,0,2,6
Totals,13,26,39,1,0,3,1,10,11
"621
                - OLYMPIC",0,3,3,0,0,0,0,3,0
"624
                - COYLE",0,0,0,0,0,0,0,0,0
"627
                - KITSAP",0,0,0,0,0,0,0,0,0
"633
                - MASON",0,0,0,0,0,0,0,0,0
"636
                - SKOKOMISH",0,3,3,0,0,0,0,3,0
"651
                - SATSOP",0,0,0,0,0,0,0,0,0
Totals,0,6,6,0,0,0,0,6,0
"601
                - HOKO",0,0,0,0,0,0,0,0,0
"602
                - DICKEY",1,1,2,0,0,0,0,1,0
"603
                - PYSHT",1,1,2,0,0,0,0,1,0
"607
                - SOL DUC",3,0,3,0,0,0,0,0,0
"612
                - GOODMAN",4,1,5,0,0,0,1,0,0
"615
                - CLEARWATER",3,1,4,0,0,0,0,1,0
Totals,12,4,16,0,0,0,1,3,0
"618
                - MATHENY",0,1,1,0,0,0,0,1,0
"638
                - QUINAULT RIDGE",0,2,2,0,0,0,1,0,1
"642
                - COPALIS",0,0,0,0,0,0,0,0,0
"648
                - WYNOOCHEE",5,0,5,0,0,0,0,0,0
"658
                - NORTH RIVER",12,0,12,0,0,0,0,0,0
"660
                - MINOT PEAK",5,1,6,0,0,0,0,1,0
"663
                - CAPITOL PEAK",0,0,0,0,0,0,0,0,0
"672
                - FALL RIVER",4,0,4,0,0,0,0,0,0
"673
                - WILLIAMS CREEK",32,0,32,0,0,0,0,0,0
"681
                - BEAR RIVER",0,0,0,0,0,0,0,0,0
"684
                - LONG BEACH",0,0,0,0,0,0,0,0,0
"699
                - LONG ISLAND",0,0,0,0,0,0,0,0,0
Totals,58,4,62,0,0,0,1,2,1
